----------------------------------                      
-   -                            -
-   -                            -
-   -                            -
-   -                     --------
-   -                            -
-   -                            -
-   -                            -
-   -             --             -
-   -                            -
-   -                            -
-   -        -                   -
-   -                     -      -        
-   -                            -
-   -         --                 -
-   -                            -
-   -                            -
-   -                 -          -
-   -                            -
-   -                            -
-   -                            -
-   -          --                -
-   -                            -
-   -                            -
-   -                            -
-   -                --          -
-   -                            -        
-   -                            -
-   -                            -
-   -          ---               -
-   -                            -
-   -                            -
-   -                            -
-   -               --           -
-   -                            -
-   -                            -
-   -                      -     -
-   -        -                   -
-   -                            -
-   -                            -
-   -                -           -        
-   -                            -
-   -                            -
-   -                       -    -
-   -                            -
-   -                -           -
-   -                            -
-   -        -                   -
-   -                 -          -
-   -                            -
-   -                        -   -
-   -                            -
-   -                --          -
-   -                            -
-   -                            -
-   -                            -
-   -  --       --               -
-   -                            -        
-   -                            -
-   -                            -
-   -     --       --      --    -
-   -                            -
-   -                            -
-   -                            -
-   -  --     -        --      - -
-   -                            -
-   -                            -
-   -                            -
-   -      --       --     --    -
-   -                            -
-   -                            -
-   -                            -
-   -           --      --       -        
-   -                            -
-   -                            -
-   -                            -
-   ---     --     --        --  -
-   -                            -
-   -                            -
-   -                            -
-   -  --       --     --      ---
-   -                            -
-   -                            -
-   -                            -
-   -       -       --      -    -
-   -                            -
-                                -
-                                -
-                -       --      -
-                                -
-                                - 
----------------------------------